1111111111111111111111111111111111
1E0000000000000C00000C0000X0000001
1010010100100000101001000000010101
1010010010101010001001000000010101
1P00X0000C00C000000000X0000X0000C1
1111111111111111111111111111111111