1111111111111111
1C0000C1C00100E1
1010P00100100001
1010010110101011
100100000C00C001
1111111111111111