1111111111111111111111111111111111
1E00000X0000000C00X00C0000X00000C1
1010010100100000101001000000010111
1010010010101010001001000110010101
1000X0000C00C00X001000XC000X0000C1
100X000X00000X0C00100C0000X0000001
1010010100100000101001000000010101
1010010010101010001001000000010101
1P00X0000C00C0XXX00000X0000X0000C1
1111111111111111111111111111111111